0100000000
0222000000
0202221000
0222020000
0200022200
0100020200
0200020100
2220022000
0222102220
0000200220
